[Maze]
28,32
1,1,1,1,1,1,1,1,1,1,1,1,1,1,1,1,1,1,1,1,1,1,1,1,1,1,1,1
0,0,0,0,0,0,0,1,1,2,2,2,2,2,2,2,2,2,2,1,1,0,0,0,0,0,0,0
1,1,1,1,1,1,0,1,1,2,1,1,1,1,1,1,1,1,2,1,1,0,1,1,1,1,1,1
1,1,1,1,1,1,0,1,1,2,1,1,1,1,1,1,1,1,2,1,1,0,1,1,1,1,1,1
1,3,2,2,2,2,2,2,2,2,2,2,2,1,1,2,2,2,2,2,2,2,2,2,2,2,3,1
1,2,1,1,1,1,1,1,1,2,1,1,2,1,1,2,1,1,2,1,1,1,1,1,1,1,2,1
1,2,1,1,1,1,1,1,1,2,1,1,2,1,1,2,1,1,2,1,1,1,1,1,1,1,2,1
1,2,1,1,2,2,2,2,2,2,1,1,2,1,1,2,1,1,2,2,2,2,2,2,1,1,2,1
1,2,1,1,2,1,1,1,1,0,1,1,2,2,2,2,1,1,0,1,1,1,1,2,1,1,2,1
1,2,1,1,2,1,1,1,1,0,1,1,1,1,1,1,1,1,0,1,1,1,1,2,1,1,2,1
1,2,2,2,2,2,2,1,1,0,1,1,1,1,1,1,1,1,0,1,1,2,2,2,2,2,2,1
1,1,1,1,1,1,2,1,1,0,0,0,0,7,0,0,0,0,0,1,1,2,1,1,1,1,1,1
1,1,1,1,1,1,2,1,1,0,1,1,1,8,8,1,1,1,0,1,1,2,1,1,1,1,1,1
1,2,2,2,2,2,2,1,1,0,1,1,1,8,8,1,1,1,0,1,1,2,2,2,2,2,2,1
1,2,1,1,1,1,2,1,1,0,1,8,8,9,8,8,8,1,0,1,1,2,1,1,1,1,2,1
1,2,1,1,1,1,2,0,0,0,1,8,8,8,8,8,8,1,0,0,0,2,1,1,1,1,2,1
1,2,2,2,1,1,2,1,1,0,1,8,8,8,8,8,8,1,0,1,1,2,1,1,2,2,2,1
1,1,1,2,1,1,2,1,1,0,1,1,1,1,1,1,1,1,0,1,1,2,1,1,2,1,1,1
0,0,1,2,1,1,2,1,1,0,0,0,0,0,0,0,0,0,0,1,1,2,1,1,2,1,0,0
0,0,1,2,1,1,2,1,1,1,1,0,1,1,1,1,0,1,1,1,1,2,1,1,2,1,0,0
0,0,1,2,1,1,2,1,1,1,1,0,1,1,1,1,0,1,1,1,1,2,1,1,2,1,0,0
0,0,1,2,2,2,2,2,2,2,2,2,1,1,1,1,2,2,2,2,2,2,2,2,2,1,0,0
0,0,1,2,1,1,1,1,1,1,1,2,1,1,1,1,2,1,1,1,1,1,1,1,2,1,0,0
1,1,1,2,1,1,1,1,1,1,1,2,1,1,1,1,2,1,1,1,1,1,1,1,2,1,1,1
0,0,0,2,2,2,2,1,1,2,2,2,0,0,4,0,2,2,2,1,1,2,2,2,2,0,0,0
1,1,1,2,1,1,2,1,1,2,1,1,1,1,1,1,1,1,2,1,1,2,1,1,2,1,1,1
1,1,1,2,1,1,2,1,1,2,1,1,1,1,1,1,1,1,2,1,1,2,1,1,2,1,1,1
1,3,2,2,1,1,2,2,2,2,2,2,2,1,1,2,2,2,2,2,2,2,1,1,2,2,3,1
1,2,1,1,1,1,2,1,1,1,1,1,2,1,1,2,1,1,1,1,1,2,1,1,1,1,2,1
1,2,1,1,1,1,2,1,1,1,1,1,2,1,1,2,1,1,1,1,1,2,1,1,1,1,2,1
1,2,2,2,2,2,2,2,2,2,2,2,2,2,2,2,2,2,2,2,2,2,2,2,2,2,2,1
1,1,1,1,1,1,1,1,1,1,1,1,1,1,1,1,1,1,1,1,1,1,1,1,1,1,1,1
[Ghost]
4
0.8
0.8
0.8
0.8
[Scatter]
6,3
21,3
1,30
26,30