8 6
%%%%%%
%....%
% %%.%
% %%.%
%.P .%
%.%%%%
%....%
%%%%%%