14 30
%%%%%%%%%%%%%%%%%%%%%%%%%%%%%%
%.      % % %        G     %.%
%  G    % % %%%%%% %%%%%%% % %
%       %        %     % %   %
%%%%% %%%%% %%% %% %%%%% % %%%
%   % % % %   %    %     %   %
% %%% % % % %%%%%%%% %%% %%% %
%       %     %%     % % %   %
%%% % %%%%%%% %%%% %%% % % % %
% %           %%     %     % %
% % %%%%% % %%%% % %%% %%% % %
%   %     %      % %   % %%% %
%.  %P%%%%%      % %%% %    .%
%%%%%%%%%%%%%%%%%%%%%%%%%%%%%%