5 9
%%%%%%%%%
%.P    G%
% %.%G%%%
%G    %%%
%%%%%%%%%