7 20
%%%%%%%%%%%%%%%%%%%%
%...%.........%%...%
%.%.%.%%%%%%%%%%.%.%
%..................%
%%%%%%%%.%.%%%%%%%P%
%%%%%%%%.......    %
%%%%%%%%%%%%%%%%%%%%