7 20
%%%%%%%%%%%%%%%%%%%%
%......%GXXG%......%
%.%%...%%XX%%...%%.%
%.%o.%........%.o%.%
%.%%.%.%%%%%%.%.%%.%
%........P.........%
%%%%%%%%%%%%%%%%%%%%