5 20
%%%%%%%%%%%%%%%%%%%%
%.           ...P .%
%.%%.%%.%%.%%.%% %.%
% %% %.....      %.%
%%%%%%%%%%%%%%%%%%%%