15 9
%%%%%%%%%
%.. % G %
%%% %%%%%
%       %
%%%%%%% %
%       %
% %%%%% %
%     % %
%%%%% % %
%     %o%
% %%%%%%%
%      .%
%%%%%%%.%
%Po    .%
%%%%%%%%%