10 5
%%%%%
% . %
%.G.%
% . %
%. .%
%   %
%  .%
%   %
%P .%
%%%%%