5 5
%%%%%
%.P %
%%% %
%.  %
%%%%%