8 8
%%%%%%%%
%.    .%
%   P  %
% %%%% %
% %    %
% % %%%%
%.%   .%
%%%%%%%%