7 7
%%%%%%%
%    P%
% %%% %
%  %  %
%%   %%
%. %%%%
%%%%%%%