5 8
%%%%%%%%
%   P G%
%G%%%%%%
%....  %
%%%%%%%%